WWWWWWWWWW
W  S     W
W  HHHH  W
W     c  W
WXXXR R  W
W  W     W
   W     W
W  X B   W
W        W
WWWWWWWWWW