WWWWWWWWWW
W  B     W
W  HHHH  W
W  R     W
W    WXXXW
W    W
W  S W   W
W    W   W
W        W
WWWWWWWWWW