WWWWWWWWWW
W  B     W
W  HHHH  W
W     c  W
W    WXXXW
W  S W
W    W   W
W    W   W
W        W
WWWWWWWWWW