WWWWWWWWWW
W  B     W
W  HHHH  W
W     cR W
W  R WXXXW
W  S W
W    W   W
W    W   W
W        W
WWWWWWWWWW