WWWWWWWWWW
W     S  W
W  HHHH  W
W  c     W
W  R WXXXW
W    W
W    W   W
W  B W   W
W        W
WWWWWWWWWW